AKK	AKAKI KALITI	ADD
ARA	ARADA	ADD
BOL	BOLE	ADD
GUL	GULELLE	ADD
KOL	KOLFE	ADD
NES	NEFAS SILK	ADD
ADK	ADDIS KETEMA	ADD
LED	LEDETA	ADD
YEK	YEKA	ADD
KIR	KIRKOS	ADD
LEK	LEMI KURA	ADD
TWO	TWO	AFA
ONE	ONE	AFA
THREE	THREE	AFA
FIVE	FIVE	AFA
FOUR	FOUR	AFA
GOW	GONDER WEST	AMH
ORO	OROMIA (AMHARA)	AMH
WAG	WAGHEMERA	AMH
GON	GONDER NORTH	AMH
WOS	WOLLO SOUTH	AMH
GOC	GONDAR CENTRAL	AMH
SHNA	SHOA NORTH(AMHARA)	AMH
GOS	GONDER SOUTH	AMH
GOE	GOJJAM EAST	AMH
WON	WOLLO NORTH	AMH
AWI	AWI	AMH
BAD	BAHIR DAR	AMH
GOW	GOJJAM WEST	AMH
DET	DESSIE TOWN	AMH
GOT	GONDER TOWN	AMH
ASOT	ASSOSA TOWN	BEN
ASS	ASSOSA	BEN
MET	METEKEL	BEN
KAM	KAMASH	BEN
MAK	MAO KOMO	BEN
DIR	DIRE DAWA	DIR
SHB	SHEBELE	SOM
SIT	SITI	SOM
JAR	JARAR	SOM
FAA	FAAFAN	SOM
AFD	AFDER	SOM
DOO	DOOLLO	SOM
LII	LIIBAN	SOM
QOR	QORAXEY	SOM
NOG	NOGOB	SOM
ERE	ERER	SOM
DWA	DAWA	SOM
QKD	QORAXEY (KEBDI DAHAR)	SOM
AGN	AGNUWA	GAM
NUE	NUER	GAM
GAB	GAMBELLA	GAM
MEZ	MEZHENGER	GAM
ITA	ITANG	GAM
HAR	HARARI	HAR
GUW	WEST GUJI	ORO
HOG	HORO GUDURU	ORO
SHNO	SHOA NORTH(OROMIA)	ORO
SHW	SHOA WEST	ORO
ARW	ARSI WEST	ORO
SHE	SHOA EAST	ORO
ADT	ADAMA TOWN	ORO
GUJ	GUJI	ORO
BAL	BALE	ORO
JIM	JIMMA	ORO
FIZ	FINFINE ZURIYA	ORO
ILL	ILLUABABOR	ORO
AMT	AMBO TOWN	ORO
SSW	SHOA SOUTH WEST	ORO
ARE	ARSI EAST	ORO
HAW	HARARGIE WEST	ORO
KEW	KELEM WELLEGA	ORO
BOR	BORENA	ORO
ASET	ASSELA TOWN	ORO
HAE	HARARGIE EAST	ORO
WEW	WELLEGA WEST	ORO
BAT	BATU TOWN	ORO
BUB	BUNO BEDELE	ORO
BIG	BISHAN GURACHA	ORO
BIT	BISHOFTU TOWN	ORO
WEE	WELLEGA EAST	ORO
BUR	BURAYU (FINFINE)	ORO
EAB	EAST BALE	ORO
DUK	DUKEM TOWN	ORO
GEL	GELAN	ORO
HOT	HOLETA TOWN	ORO
JIT	JIMMA TOWN	ORO
LEG	LEGETAFO	ORO
MOT	MOJO TOWN	ORO
NET	NEKEMTE TOWN	ORO
RTA	ROBE TOWN ADM.	ORO
SEB	SEBETA	ORO
SHT	SHASHEMENE TOWN	ORO
SUL	SULULTA	ORO
WOT	WOLISO TOWN	ORO
SID	SIDAMA	SID
HAT	HAWASSA TOWN	SID
SIL	SILTI	SNNP
GAM	GAMMO	SNNP
WEL	WELAYITA	SNNP
GUR	GURAGE	SNNP
KET	KEMBATA & TEMBARO	SNNP
KAF	KAFA	SNNP
ESP	ELIE SP.WEREDA	SNNP
AMA	AMARO	SNNP
HAD	HADEYA	SNNP
KOT	KONTA	SNNP
SHK	SHEKA	SNNP
HAL	HALABA	SNNP
BES	BENCH SHEKO	SNNP
BAS	BASKETO	SNNP
OMS	OMO SOUTH	SNNP
OMW	WEST OMO	SNNP
GED	GEDEO	SNNP
GOF	GOFFA	SNNP
DSP	DHERASHE SP.WEREDA	SNNP
DWR	DAWRO	SNNP
YEM	YEM	SNNP
KOS	KONSO	SNNP
BSP	BURJI SP.WEREDA	SNNP
CEN	CENTERAL	TIG
SOU	SOUTHERN	TIG
WES	WESTERN	TIG
NWE	N.WESTERN	TIG
EAS	EASTERN	TIG
MES	MEKELE SPECIAL	TIG

